31
31
1111111111111111111111111111111
2000001000000000100000100000101
1110111011111110101011101110101
1000100010001000101010001000001
1011101110101010111010111011111
1000001000100010100010100010001
1111111011111110101110101110101
1000000010001000101000100000101
1011111110101011101011111111101
1000100000101010001010000010101
1110111111101010111011101010101
1010000010001000100000001010001
1011101010111111111111111010111
1010001010000000000010000010001
1010111010111111111011101111101
1000100000100010000010001000101
1111101011111010111110111110101
1000101010001010100000000010101
1110101011101010111111111010111
1000001000001000100010000010001
1011111111111110101010111110101
1000100010000010001010001000101
1110101010111011111011101111101
1010101010100010001000001000101
1010101010101110101111101010101
1000101000100010100010001010001
1110101011101110101110111011111
1000101010001000100010100000101
1011111010111011111010111110101
1000000010000010000010000000003
1111111111111111111111111111111