31
31
1111111111111111111111111111111
2444001444444444100000100000101
1114111411111114101011101110101
1444144414441444101010001000001
1411141114141410111010111011111
1444441444144410100010100010001
1111111411111110101110101110101
1444444410001000101000100000101
1411111110101011101011111111101
1444100000101010001010000010101
1114111111101010111011101010101
1014444410001000100000001010001
1011101410111111111111111010111
1010001414444444444410000010001
1010111414111111111411101111101
1000100444100014444410001000101
1111101011111014111110111110101
1000101010001014100000000010101
1110101011101014111111111010111
1000001000001004144410000010001
1011111111111114141410111110101
1000100010000014441410001000101
1110101010111011111411101111101
1010101010100010001444441000101
1010101010101110101111141010101
1000101000100010100014441010001
1110101011101110101114111011111
1000101010001000100014100000101
1011111010111011111014111110101
1000000010000010000014444444443
1111111111111111111111111111111
